...............xx...............
..........v....xx....v..........
..o..........................o..
..xx...........xx...........xx..
...............xx...............
...............xx...............
.....x....................x.....
.....x....................x.....
.....x....................x.....
................................
........o...o......o...o........
........xxxxx......xxxxx........
................................
...o........................o...
...x..........x..x..........x...
..............xxxx..............
................................
^..............................^